CHR,POS1,POS2,N_CHR,r2,D,Dprime,gen_dist,LD_group,no_var_group
CP021825.1,1356055,1356058,49,1,0.13661,1,3,3,2
CP021827.1,1202378,1202379,43,1,0.151433,1,1,5,2
CP021827.1,1014386,1014389,47,1,0.190131,1,3,6,2
CP021827.1,662628,662633,49,1,0.0749688,1,5,11,2
CP021827.1,661801,661804,44,1,0.237087,1,3,12,2
CP021827.1,596707,596728,49,1,0.232403,1,21,14,2
CP021827.1,586673,586676,48,1,0.1875,1,3,15,2
CP021827.1,352366,352369,49,1,0.0574761,1,3,21,2
CP021828.1,300817,300818,47,1,0.224536,1,1,23,2
CP021828.1,272714,272788,48,1,0.0399306,1,74,26,2
CP021828.1,267473,267477,45,1,0.0424691,1,4,28,2
CP021828.1,256680,256735,44,1,0.208161,1,55,29,2
CP021828.1,249121,249146,47,1,0.217293,1,25,30,2
CP021827.1,962638,962653,48,1,0.0399306,1,15,7,3
CP021827.1,962644,962653,48,1,0.0399306,1,9,7,3
CP021827.1,962638,962644,49,1,0.0391504,1,6,7,3
CP021827.1,793559,793588,46,1,0.113422,1,29,9,3
CP021827.1,793579,793588,47,1,0.126754,1,9,9,3
CP021827.1,793559,793579,46,1,0.113422,1,20,9,3
CP021827.1,431598,431631,46,1,0.0609641,1,33,17,3
CP021827.1,431624,431631,46,1,0.0609641,1,7,17,3
CP021827.1,431598,431624,49,1,0.0574761,1,26,17,3
CP021828.1,288074,365824,45,1,-0.0424691,-1,77750,19,3
CP021828.1,288091,365824,43,1,-0.022715,-1,77733,19,3
CP021828.1,626055,626056,48,1,0.109375,1,1,13,4
CP021828.1,626021,626038,48,1,0.109375,1,17,13,4
CP021827.1,556101,556106,46,1,0.170132,1,5,16,4
CP021827.1,554063,554119,49,1,0.244898,1,56,16,4
CP021828.1,301029,301039,43,1,0.0443483,1,10,22,4
CP021828.1,301032,301039,44,1,0.0433884,1,7,22,4
CP021828.1,301035,301039,43,1,0.0443483,1,4,22,4
CP021828.1,301029,301035,45,1,0.0424691,1,6,22,4
CP021828.1,301032,301035,46,1,0.0415879,1,3,22,4
CP021828.1,301029,301032,46,1,0.0415879,1,3,22,4
CP021828.1,288070,288091,47,1,-0.0208239,-1,21,24,4
CP021828.1,288074,288091,47,1,0.0208239,1,17,24,4
CP021828.1,288081,288091,46,1,0.0212665,1,10,24,4
CP021828.1,268186,268239,49,1,0.232403,1,53,27,4
CP021828.1,268201,268239,49,1,0.232403,1,38,27,4
CP021828.1,268207,268239,49,1,0.232403,1,32,27,4
CP021828.1,268186,268207,49,1,0.232403,1,21,27,4
CP021828.1,268201,268207,49,1,0.232403,1,6,27,4
CP021828.1,268186,268201,49,1,0.232403,1,15,27,4
CP021828.1,898491,898533,49,1,0.0391504,1,42,8,5
CP021828.1,898511,898533,49,1,0.0391504,1,22,8,5
CP021828.1,898518,898533,49,1,0.0391504,1,15,8,5
CP021828.1,898531,898533,49,1,0.0391504,1,2,8,5
CP021828.1,898491,898531,49,1,0.0391504,1,40,8,5
CP021828.1,898511,898531,49,1,0.0391504,1,20,8,5
CP021828.1,898518,898531,49,1,0.0391504,1,13,8,5
CP021828.1,898491,898518,49,1,0.0391504,1,27,8,5
CP021828.1,898511,898518,49,1,0.0391504,1,7,8,5
CP021828.1,898491,898511,49,1,0.0391504,1,20,8,5
CP021827.1,1238804,1238814,44,1,0.117769,1,10,4,6
CP021827.1,1238757,1238766,42,1,0.0663265,1,9,4,6
CP021827.1,1238268,1238277,46,1,0.0609641,1,9,4,6
CP021827.1,708956,709006,46,1,0.157372,1,50,10,6
CP021827.1,708434,708435,48,1,0.249566,1,1,10,6
CP021827.1,703575,703578,49,1,0.0574761,1,3,10,6
CP021828.1,285307,285310,48,1,0.124566,1,3,25,6
CP021828.1,284765,284766,47,1,0.200091,1,1,25,6
CP021828.1,284714,284723,47,1,0.0597555,1,9,25,6
CP021825.1,1732438,1732501,48,1,0.0585938,1,63,1,7
CP021825.1,1732500,1732501,48,1,0.0763889,1,1,1,7
CP021825.1,1732438,1732500,47,1,0.0597555,1,62,1,7
CP021825.1,1732447,1732456,49,1,0.0391504,1,9,1,7
CP021825.1,1732453,1732456,49,1,0.0391504,1,3,1,7
CP021825.1,1732454,1732456,49,1,0.0391504,1,2,1,7
CP021825.1,1732447,1732454,49,1,0.0391504,1,7,1,7
CP021825.1,1732453,1732454,49,1,0.0391504,1,1,1,7
CP021825.1,1732447,1732453,49,1,0.0391504,1,6,1,7
CP021828.1,247245,247256,49,1,0.244898,1,11,31,9
CP021828.1,247252,247256,49,1,0.244898,1,4,31,9
CP021828.1,247245,247252,49,1,0.244898,1,7,31,9
CP021828.1,247150,247181,48,1,0.0585938,1,31,31,9
CP021828.1,247151,247181,47,1,0.0597555,1,30,31,9
CP021828.1,247162,247181,47,1,0.0597555,1,19,31,9
CP021828.1,247178,247181,48,1,0.0585938,1,3,31,9
CP021828.1,247162,247168,47,1,0.0597555,1,6,31,9
CP021828.1,247150,247162,48,1,0.0585938,1,12,31,9
CP021828.1,247151,247162,47,1,0.0597555,1,11,31,9
CP021828.1,247150,247151,48,1,0.0585938,1,1,31,9
CP021828.1,365883,365902,48,1,0.246094,1,19,18,11
CP021828.1,365899,365902,48,1,0.246094,1,3,18,11
CP021828.1,365883,365899,48,1,0.246094,1,16,18,11
CP021828.1,365865,365880,45,1,0.0424691,1,15,18,11
CP021828.1,365868,365880,45,1,0.0424691,1,12,18,11
CP021828.1,365872,365880,46,1,0.0415879,1,8,18,11
CP021828.1,365865,365872,46,1,0.0415879,1,7,18,11
CP021828.1,365868,365872,46,1,0.0415879,1,4,18,11
CP021828.1,365865,365868,45,1,0.0424691,1,3,18,11
CP021828.1,365854,365857,45,1,-0.16,-1,3,18,11
CP021828.1,365824,365828,42,1,0.0453515,1,4,18,11
CP021828.1,365701,365703,45,1,0.131358,1,2,20,12
CP021828.1,365581,365582,44,1,0.208161,1,1,20,12
CP021828.1,365443,365479,48,1,0.0763889,1,36,20,12
CP021828.1,365419,365422,45,1,-0.0809877,-1,3,20,12
CP021828.1,365158,365161,49,1,0.0574761,1,3,20,12
CP021828.1,365140,365142,48,1,0.0763889,1,2,20,12
CP021825.1,1377836,1377877,47,1,0.111363,1,41,2,16
CP021825.1,1377850,1377877,47,1,0.111363,1,27,2,16
CP021825.1,1377854,1377877,47,1,0.111363,1,23,2,16
CP021825.1,1377863,1377869,47,1,0.0597555,1,6,2,16
CP021825.1,1377836,1377854,48,1,0.109375,1,18,2,16
CP021825.1,1377850,1377854,48,1,0.109375,1,4,2,16
CP021825.1,1377836,1377850,48,1,0.109375,1,14,2,16
CP021825.1,1377569,1377623,48,1,0.0585938,1,54,2,16
CP021825.1,1377605,1377623,48,1,0.0585938,1,18,2,16
CP021825.1,1377569,1377605,49,1,0.0574761,1,36,2,16
CP021825.1,1377329,1377350,49,1,-0.0391504,-1,21,2,16
CP021825.1,1377338,1377350,49,1,-0.0391504,-1,12,2,16
CP021825.1,1377344,1377350,49,1,0.0391504,1,6,2,16
CP021825.1,1377347,1377350,49,1,-0.0391504,-1,3,2,16
CP021825.1,1377329,1377347,49,1,0.0391504,1,18,2,16
CP021825.1,1377338,1377347,49,1,0.0391504,1,9,2,16
CP021825.1,1377344,1377347,49,1,-0.0391504,-1,3,2,16
CP021825.1,1377329,1377344,49,1,-0.0391504,-1,15,2,16
CP021825.1,1377338,1377344,49,1,-0.0391504,-1,6,2,16
CP021825.1,1377329,1377338,49,1,0.0391504,1,9,2,16
CP021825.1,1377320,1377321,49,1,0.0574761,1,1,2,16
